1111111
1P000C1
1000011
10M0001
100E001
1111111
